########################################################################################################################################################  
#                                           #~~~~~~~~~~~~~~~~~~~#                                                                                      #  
#                                           #~~~~~~~~~~~~~~~~~~~#                                                                                      #  
#                                           #~~~~~~~~~~~~~~~~~~~#                                                                                      #  
#                                           #~~~~~~~~~~~~~~~~~~~#                                                                                      #  
#########                                   #~~~~~~~~~~~~~~~~~~~#                  #~~~~~~~~~~~~~~~~~                                                  #  
#~~~~~~~##############                      #~~~~~~~~~~~~~~~~~~~#                  #~~~~~~~~~~~~~~~~~                                                  #  
#~~~~~~~~~~~~~~~~~~~~####     ###############~~~~~~~~~~~~~~~~~~~#                  #~~~~~~~~~~~~~~~~~                                                  #  
#~~~~~~~~~~~~~~~~~~~~~~~#     #~~~~~~~~~~~~~~~~~~~~~~~~~~~~~~~~~#                  #~~~~~~~~~~~~~~~~~                                                  #  
#~~~~~~~~~~~~~~~~~~~~~~~#     #~~~~~~~~~~~~~~~~~~~~~~~~~~~~~~~~~#                  #~~~~~~~~~~~~~~~~~                                                  #  
#~~~~~~~~~~~~~                          ~~~~~~~~~~~~~~~~~~~~~~~~#                  #~~~~~~~~~~~~~~~~~                                                  #  
#~~~~~~~~~~~~~                          ~~~~~~~~~~~~~~~~~~~~~~~~#                  #~~~~~~~~~~~~~~~~~                                                  #  
#~~~~~~~~~~~~~                          ~~~~~~~~~~~~~~~~~~~~~~~~#                  #~~~~~~~~~~~~~~~~~                                                  #  
#~~~~~~~~~~~~~                          ~~~~~~~~~~~~~~~~~~~~~~~~#                  #~~~~~~~~~~~~~~~~~                                                  #  
#~~~~~~~~~~~~~                          ~~~~~~~~~~~~~~~~~~~~~~~~#                  #~~~~~~~~~~~~~~~~~                                                  #  
#~~~~~~~~~~~~~~~~~~~~~~~~#     #~~~~~~~~~~~~~~~~~~~~~~~~~~~~~~~~#                  #~~~~~~~~~~~~~~~~~                                                  #  
#~~~~~~~~~~~~~~~~~~~~~~~~#     #~~~~~~~~~~~~~~~~~~~~~~~~~~~~~~~~#                  #~~~~~~~~~~~~~~~~~~~~~~~~~~~~~~~~~~                                 #  
#~~~~~~~~~~~~~~~~~~~~~~~~#     #~~~~~~~~~~~~~~~~~~~~~~~~~~~~~~~~#                  #~~~~~~~~~~~~~~~~~~~~~~~~~~~~~~~~~~                                 #  
#~~~~~~~~~~~~~~~~~~~~~~~~#     #~~~~~~~~~~~~~~~~~~~~~~~~~~~~~~~~#                  #~~~~~~~~~~~~~~~~~~~~~~~~~~~~~~~~~~                                 #  
#                                                                                  #~~~~~~~~~~~~~~~~~~~~~~~~~~~~~~~~~~                                 #  
#                                                                                  #~~~~~~~~~~~~~~~~~~~~~~~~~~~~~~~~~~                                 #  
#                                                                                  #~~~~~~~~~~~~~~~~~~~~~~~~~~~~~~~~~~                                 #  
#                                                                                  #~~~~~~~~~~~~~~~~~~~~~~~~~~~~~~~~~~                                 #  
#                                                                                  #~~~~~~~~~~~~~~~~~~~~~~~~~~~~~~~~~~                                 #  
#                                                                                  #~~~~~~~~~~~~~~~~~~~~~~~~~~~~~~~~~~                                 #  
#                                                                                  #~~~~~~~~~~~~~~~~~~~~~~~~~~~~~~~~~~                                 #  
#                                                                                  #                                                                   #  
#                                                                                  #  X                                                                #  
#                                                                                  #                                                                   #  
########################################################################################################################################################  