########################################################################################################################################################  
#         #~~~~~~~~~~~~~~~~~~~#                                                                 ~~~~~~~~~~~~~~~                                        #  
#         #~~~~~~~~~~~~~~~~~~~#                                                                 ~~~~~~~~~~~~~~~                                        #  
#         #~~~~~~~~~~~~~~~~~~~#######~~~~~~~~~~~~~~~~#                                          ~~~~~~~~~~~~~~~       ###############                  #  
#                                   #~~~~~~~~~~~~~~~~#                                          ~~~~~~~~~~~~~~~       ##                               #  
#                                   #~~~~~~~~~~~~~~~~#                  ##~~~~~~~~~~~~~~~~#     ~~~~~~~~~~~~~~~       ##    ~~~~     ~~~~     ~~~~     #  
####################                #~~~~~~~~~~~~~~~~#                  ##~~~~~~~~~~~~~~~~#     ~~~~~~~~~~~~~~~       ##    ~~~~     ~~~~     ~~~~     #  
#~~~~~~~~~~~~~~~~~~######   #########~~~~~~~~~~~~~~~~#                  ##~~~~~~~~~~~~~~~~#     ~~~~~~~~~~~~~~~       ##    ~~~~     ~~~~     ~~~~     #  
#~~~~~~~~~~~~~~~~~~~~~~~#   #~~~~~~~~~~~~~~~~~~~~~~~~#                  ##~~~~~~~~~~~~~~~~#     ~~~~~~~~~~~~~~~       ##                               #  
#~~~~~~~     ~~~~~~~~~~~#   #~~~~~~~~~~~~~~~~~~~~~~~~#                  ##~~~~~~~~~~~~~~~~#     ~~~~~~~~~~~~~~~       ##                               #  
#~~~~~~~     ~~~~~~~~~~~#   #~~~~~~~~~~~~~~~~~~~~~~~~#                  ##~~~~~~~~~~~~~~~~#     ~~~~~~~~~~~~~~~       ##        ~~~~~    ~~~~~         #  
#~~~~~~~     ~~~~~~~~~~~#   #~~~~~~~~~~~~~~~~~~~~~~~~#                  ##~~~~~~~~~~~~~~~~#     ~~~~~~~~~~~~~~~       ##        ~~~~~    ~~~~~         #  
#~~~~~~~     ~~~~~~~~~~~#   #~~~~~~~~~~~~~~~~~~~~~~~~#                  ##~~~~~~~~~~~~~~~~#     ~~~~~~~~~~~~~~~       ##        ~~~~~    ~~~~~         #  
#~~~~~~~                    #~~~~~~~~~~~~~~~~~~~~~~~~#                  ##~~~~~~~~~~~~~~~~#     ~~~~~~~~~~~~~~~       ##                               #  
#~~~~~~~~~                  #~~~~~~~~~~~~~~~~~~~~~~~~#                  ##~~~~~~~~~~~~~~~~#                           ##                               #  
#~~~~~~~~~~~~~~~~~~~~~~~#   #~~~~~~~~~~~~~~~~~~~~~~~~#                  ##~~~~~~~~~~~~~~~~#                           ##                               #  
#~~~~~~~~~~~~~~~~~~~~~~~#   #~~~~~~~~~~~~~~~~~~~~~~~~#                  ##~~~~~~~~~~~~~~~~#######################################################      #  
#~~~~~~~~~~~~~~~~~~~~~~~#   #~~~~~~~~~~~~~~~~~~~~~~~~#                  ##~~~~~~~~~~~~~~~~~~~~~~~~~~~~~~~~~~~~~                                        #  
#~~~~~~~~~~~~~~~~~~~~~~~#   #~~~~~~~~~~~~~~~~~~~~~~~~#                  ##~~~~~~~~~~~~~~~~~~~~~~~~~~~~~~~~~~~~~                                        #  
#########################   #                                           ##~~~~~~~~~~~~~~~~~~~~~~~~~~~~~~~~~~~~~        #                               #  
#                           #                                           ##~~~~~~~~~~~~~~~~~~~~~~~~~~~~~~~~~~~~~        #                               #  
#                           #          ##~~~~~~~~~~~~~~                 ##~~~~~~~~~~~~~~~~~~~~~~~~~~~~~~~~~~~~~        #                               #  
#         ###################          ##~~~~~~~~~~~~~~                 ##~~~~~~~~~~~~~~~~~~~~~~~~~~~~~~~~~~~~~        #                               #  
#         ###################          ##~~~~~~~~~~~~~~                 ##~~~~~~~~~~~~~~~~~~~~~~~~~~~~~~~~~~~~~        #                               #  
#                                      ##~~~~~~~~~~~~~~                 ##~~~~~~~~~~~~~~~~~~~~~~~~~~~~~~~~~~~~~        #                               #  
#                                      ##~~~~~~~~~~~~~~                 ##~~~~~~~~~~~~~~~~~~~~~~~~~~~~~~~~~~~~~        #                               #  
#         ~~~~~~~~~~~~~~~~~~~~~~       ##~~~     ~~~~~~                 ##                                             #                               #  
#         ~~~~~~~~~~~~~~~~~~~~~~       ##~~~     ~~~~~~                 ##  X                                          #                               #  
#         ~~~                          ##~~~                            ##                                             #                               #  
########################################################################################################################################################  