########################################################################################################################################################   
#                                                             #####~~~~~~~~~~~~~~~~~~~#####                                                            #  
#                                                            #####~~~~~~~~~~~~~~~~~~~~~#####                                                      X    #  
#                                                           ###~~~~~~~~~~~~~~~~~~~~~~~~~~~###                                                          #  
#################################################          ##~~~~~~~~~~~~~~~~~~~~~~~~~~~~~~~##          ################################################  
#                                                          #~~~~~~~~~~~~~~~~~~~~~~~~~~~~~~~~~#                                                         #  
#                                                          #~~~~~~~~~~~~~~~~~~~~~~~~~~~~~~~~~#                                                         #  
#                                                          #~~##########~~~~~~~~~##########~~#                                                         #  
#         ##################################################~~        ###~~###~~###        ~~###############################################           #  
#                                                          #~~          #########          ~~#                                                         #  
#                                                                        #######                                                                       #  
#                                                          #~~~~~~~~~~~~~~~###~~~~~~~~~~~~~~~#                                                         #  
#############################################             ##~~~~~~~~~~~~~~~ # ~~~~~~~~~~~~~~~##             ############################################  
#                                                         ####~~~~~~~~~~~   #   ~~~~~~~~~~~####                                                        #  
#                                                         #########~~~~~   ###   ~~~~~#########                                                        #  
#                                                           #########~~~~~#####~~~~~#########                                                          #  
#                                                            ~~ ~~~###~~~~#####~~~~###~~~ ~~                                                           #  
#                                                            ~~  ~~~~~~~~#######~~~~~~~~  ~~                                                           #  
#                                                            ~~  ~## ### ### ### ### ##~  ~~                                                           #  
#                                                            ~~  ~## ### ### ### ### ##~  ~~                                                           #  
#                                                             ~~ ~~~~~~~~~~~~~~~~~~~~~~~ ~~                                                            #  
#                                                             ###~~~~~~~~#######~~~~~~~~###                                                            #  
#                                                               ###~~~~~#########~~~~~###                                                              #  
#                                                                 #####################                                                                #  
#                                                                    ###############                                                                   #  
#                                                                        #######                                                                       #  
#                                                                                                                                                      #  
#                                                                                                                                                      #  
#                                                                                                                                                      #  
########################################################################################################################################################  