########################################################################################################################################################   
#                                                                                                                                                      #  
#                                                                                                                                                      #  
#                                                                                                                                                      #  
#                                                                                                                                                      #  
#                                                                                                                                                      #  
#                                                                                                                                                      #  
#                                                                                                                                                      #  
#                                                                                                                                                      #  
#                                                                                                                                                      #  
#                                                                                                                                                      #  
#                                                                                                                                                      #  
#                                                                                                                                                      #  
#                                                                                                                                                      #  
#                                                                                                                                                      #  
#                                                                                                                                                      #  
#                                                                                                                                                      #  
#                                                                                                                                                      #  
#                                                                                                                                                      #  
#                                                                                                                                                      #  
#                                                                                                                                                      #  
#                                                                                                                                                      #  
#                                                                                                                                                      #  
#                                                                                                                                                      #  
#                                                                                                                                                      #  
#                                                                                                                                                      #  
#                                                                                                                                                      #  
#                                                                                                                                                      #  
#                                                                                                                                                      #  
########################################################################################################################################################  